اے۔	A
بی۔	B
سی۔	C
ڈی۔	D
ای۔	E
ایف۔	F
جی۔	G
ایچ۔	H
میں۔	I
جے۔	J
کے	K
ایل۔	L
ایم۔	M
این۔	N
او۔	O
پی۔	P
ق۔	Q
آر۔	R
ایس۔	S
ٹی۔	T
ڈبلیو۔	W
ایکس	X
ﻱ	Y
زیڈ	Z