ডবল আ	AA
ডবল এ	AA
ডবল যে	AA
ডবল এই	AA
ডবল ব	BB
ডবল বি	BB
ডবল সি	CC
ডবল ডি	DD
ডবল ই	EE
ডবল ফ	FF
ডবল এফ	FF
ডবল জি	GG
ডবল হ	HH
ডবল এইচ	HH
ডবল ই	II
ডবল জে	JJ
ডবল কে	KK
ডবল ল	LL
ডবল ম	MM
ডবল এল	MM
ডবল এম	MM
ডবল এন	NN
ডবল ও	OO
ডবল প	PP
ডবল পি	PP
ডবল কিউ	QQ
ডবল আর	RR
ডবল স্	SS
ডবল এস	SS
ডবল টি	TT
ডবল টিি	TT
ডবল উ	UU
ডবল ইউ	UU
ডবল ভি	VV
ডবল উ	WW
ডব্লিউ	WW
ডবল ডাব্লিউ	WW
ডবল এক্স	XX
ডবল ই	YY
ডবল জ	ZZ
ডবলজড়	ZZ
ডবল জ্যাড	ZZ
ডবল এড়	ZZ
ডবল জেড	ZZ
